NO ./textures/bluestone.xpm
SO ./textures/greystone.xpm
WE ./textures/redbrick.xpm
EA ./textures/wood.xpm

F 220,100,0
C 225,255,255

11111111111111111111111
10000000001100000000001
10110000011100000000001
10010000000000000000001
11011111101100011100001
10000001111111111101111
11110111       10000001
11110111       10101001
11000001111111 10000001
10000000000001 10000001
10000000000001 1S101001
11000011111001 111101111
1111011   1001   10111101
1111111   1111   11111111
