NO ./textures/bluestone.xpm
SO ./textures/greystone.xpm
WE ./textures/redbrick.xpm
EA ./textures/wood.xpm

F 0,200,0
C 225,30,100

1111111111
10000000E1
1000000001
1000000001
11111111111
         11111111111
          1000000001
          1000000001
          1000000001
          1111111111
