NO ./path_to_the_north_texture
SO ./path_to_the_south_texture
WE ./path_to_the_west_texture
EA ./path_to_the_east_texture



F 220,100,1
C 255,30,100



1111111111111111111111111
1000000000110000000000001
1011111111110000000001111
1001       11111111111  111
1111111111110000011101  101
10000000001100000111011110111
11110111111111011100000010001
111101       1011101010010001
11000111111111011100000010001
10000000000000001100000010001
10000000000000001111110010001
1001111111110E01111  11110011
10000001 11101000011110100011
11111111 11111111111111111111
